NO ./textures/star_wall1.xpm
SO ./textures/star_wall2.xpm
WE ./textures/star_wall3.xpm
EA ./textures/star_wall4.xpm

C 255,255,255
F 170,170,170

11111111111111111111111111111
1E000000000010000000000000001
11111111111011101111011110111
        110001000110001100011
11111111101010101111011110111
10000000000000000000000000001
11111111101011111111111111111
        11111