NO ./textures/Gryffindor.xpm
SO ./textures/Hufflepuff.xpm
WE ./textures/Ravenclaw.xpm
EA ./textures/Slytherin.xpm

C 200,20,8
F 0,45,100

111111111111111111111
100000000000000000001
100000000000000000001
100000000000000000001
100000000000000000111
1000000000000000001
100000000000000000111
100000000000000000001
100000000000000000001
100000000000000000001
100000000000011100001
100000000000010100001
100000000000011100001
100000000000000000001
100000000000000000001
100000000000000000001
111111111100000000001
        1000000000001
111111111100000000001
1E0000000100000000001
111111111111111111111