NO ./textures/21.xpm
SO ./textures/Hufflepuff.xpm
WE ./textures/Ravenclaw.xpm
EA ./textures/Slytherin.xpm

C 200,20,8
F 0,45,100

111111111111111111111
100000000000000000001
100000000000000000001
100000000000000000001
100000000000000000111
1000000000000000001
100110000000000000111
101000000000000000001
101000000000000000001
101000000000000000001
101000000000N11100001
101000000000010100001
101000000000011100001
101000000000000000001
101000000000000000001
101000000000000000001
101000000000000000001
101000000000000000001
101000000000000000001
1N1000000000000000001
111111111111111111111