NO ./textures/gravel.xpm
SO ./textures/redpattern.xpm
WE ./textures/hierba.xpm
EA ./textures/yelltexpattern.xpm


F 102,0,1
C 102,178,225


        11111111111 1111111111111
        1000000000110000000000001
  1111111011000001110000000000001
 1001000000000000000000001111111
111111111011000001110000000000001
100000000011000001110111111111111
11110111111111011100000010001
11110111111111011101010010001
1100000011010101 100000010001
1000000000000001 100000010001
1000000000000001 101010010001
1100000111010101 111011110N0111
11110111 1110101 101111010001
11111111 1111111 111111111111