1111111111
1N00000001
1010000101
1000000001
1111111111
