NO ./textures/gravel.xpm
SO ./textures/redpattern.xpm
WE ./textures/hierba.xpm
EA ./textures/11.xpm


F 102,0,1
C 102,178,225


        1111111111111111111111111
        10000000001100000000000011
 111111110110000011100000000000001
 100100000000000000000000111111111
111111111011000001110000000000001
100000000011000001110111111111111
11110111111111011100000010001
1111011111111101 101010010001
1100000011010101 100000010001
1000000000000001 100000000001
1000000000000001 1N1010010001
1100000111010101 111011110001
 1110111 1110101 101111010001
   111     11111 111111111111