NO ./textures/north.xpm
SO ./textures/south.xpm
WE ./textures/west.xpm
EA ./textures/east.xpm

C 200,20,8
F 0,45,100

111111111111111111111
100000000000000000001
100000000000000000001
100000000000000000001
100000000000000000111
1000000000000000001
100000000000000000111
100000000000000000001
100000000000000000001
100000000000000000001
100000000000011100001
100000000000010100001
100000000000011100001
100000000000000000001
100000000000000000001
100000000000000000001
100000000000000000001
100000000N00000000001
100000000000000000001
100000000000000000001
111111111111111111111